111111111111
1P0C0C0C0C01
1111111111C1
1C0C0C0C0101
10111111C1C1
1C1C0C010101
101011C1C1C1
1C1C1E010101
10101111C1C1
1C1C0C0C0101
1011111111C1
1C0C0C0C0C01
111111111111
