11111111111111111111111
1P111000000000000000001
10011011111111111111101
11C01C01E011110001110C1
111C01C01C0110C10110C11
1111C01C01CCCC10C10C111
11111C01C011110C10C1111
111111C01C0110C10C11111
1111111C01CCCC10C111111
11111111C011110C1111111
111111111C0110C11111111
1111111111CCCC111111111
11111111111111111111111

