1111111111111111111
1CCCC1CCCCCCC1CCCC1
1C11C1C11111C1C11C1
1CCCCCCCCCCCCCCCCC1
11C1C111C1C111C1C11
10C1CCCCC1CCCCC1C01
11C1110111110111C11
11C0000000000000C11
11C1110110110111C11
11C100010E010001C11
11C1010111110101C11
10C0010000000100C01
11C1111101011111C11
11CCCCC00100CCCCC11
11C111C11111C111C11
1CCCCCCCCPCCCCCCCC1
1C11C111C1C111C11C1
1C11C1CCC1CCC1C11C1
1C11C1C11111C1C11C1
1CCCCCCCCCCCCCCCCC1
1111111111111111111
