11111111111111111111111111111111111111
10CCCC0CCCC000000C0000CCCC0C00C0CCCC01
1011110111100000010000111101C010111101
10100101001000000100001001011C10100101
101P0001001000000100001001011C10100001
1011110100100000010000100101011010E001
10C00101001000000100001001010110101101
101CC1010010CCCC01CCC010010100101CC101
10111101111011110111101111010010111101
10000000000000000000000000000000000001
11111111111111111111111111111111111111
