11111111111111111111111111111111111111
10000000000000000000000000000000000001
1011000000000000000000000CC01111100001
10011011100000000000CC0000001000100001
100010110100000000000000000011111E0001
1001011110110CC00000000C0C000001110001
10001011010000000CC000C000C00000011101
100110111000000000000C0C0C0C0000000101
101100000000000000000000C0001110000001
100000000000000000000C0C0C0C1010000011
10000000C0000000000000C000C11000000011
1001000C0C0011111000000C0C111100000101
1P101000C00010000110111001110110001001
11010110000101110001111011001011010001
10011011101010001011111010010101110001
11111111111111111111111111111111111111
