111111111111111
10P000000CCC001
101100000111001
100100000001001
100000000000001
100000000000001
100000000000001
1000000000CCC01
10000CC00011101
1000C1100001001
100011000000001
1000000000000C1
100000000000011
100C00000000011
100100000000011
100000000100011
1CCCCCCCC1CCCC1
11CCC1CCCCCCCC1
11C111111CC11C1
11C1111111111C1
11C1010111101E1
111111011100011
110011101101111
111111111111111
